111111111111111
100000000000001
100000000000001
100000000000001
100000000000001
100000000000001
100000000000001
100000000000001
100000000000001
100000000000001
111111101111111
111110000011111
111110000011111
111111111111111
111111111111111